------------X
------------X
------------X
------------X
------------X
------------X
------------X
------------X
------------X
------------X
------------X
------------X
------------X
------------X
-----------EX
-----------EX
------------X
-----------EX
------------X
------------X
------------X
------------X
------------X
------------X
-----------EX
------------X
------------X
------------X
--------<[[[X
-------->]]]X
------------X
------------X
------------X
------------X
-----------EX
------------X
-----------EX
------------X
------------X
-------------
------------X
-------------
------------X
------------X
-------------
------------X
------------X
-------------
------------X
------------X
-------------
-----------EX
------------X
------------X
------------X
------------X
------------X
-------o----X
------------X
------------X
------------X
-----------EX
------------X
-----------EX
-----------EX
------------X
------------X
------------X
------------X
--------<[[[X
-------->]]]X
------------X
------------X
-------P----X
------------X
---------<[[X
--------->]]X
------------X
------------X
------------X
------------X
------------X
-------o----X
------------X
------------X
------------X
------------X
--------<[[[X
-------->]]]X
------------X
------------X
-------o----X
------------X
------------X
------------X
------------X
------------X
--------<[-[X
-------->]-]X
------------X
-----------EX
-----------EX
---o--------X
---o-------EX
------------X
------------X
------------X
------------X
----------<[X
---------->]X
------------X
------------X
------------X
------------X
------------X
------------X
-----------EX
------------X
------------X
------------X
------------X
-----------EX
------------X
-----------EX
-----------EX
------------X
------------X
------------X
------------X
------------X
------------X
------------X
------------X
---------<[[X
--------->]]X
------------X
------------X
------------X
------------X
------------X
-----------EX
-----------EX
------------X
-----------EX
------------X
------------X
--------XXXXX
----S-------X
----S-------X
----S-------X
----S-------X
----X---X---X
----S----E--X
----S-------X
----S-------X
------------X
--------XXXXX
------------X
------------X
------------X
------------X
------------X
-------------
------------X
--------E----
------------X
------------X
-------------
----------E-X
-------------
------------X
------------X
-------------
------------X
------------X
------------X
------------X
-------S----X
-------S----X
-------P----X
-------S----X
-------S----X
-------S----X
-------S----X
-------S----X
------------X
------------X
------------X
------------X
------------X
-------------
------------X
-------------
------------X
-------------
------------X
------------X
------------X
-----------EX
------------X
------------X
------------X
------------X
----------XXX
------------X
------------X
------------X
------------X
------------X
------------X
------------X
------------X
------------X
------------X
-------------
-------------
-------o-----
-------o-----
-------------
-------------
------------X
------------X
------------X
------------X
-----------EX
------------X
-----------EX
-----------EX
------------X
------------X
-------------
---------<[[X
--------->]]X
-------------
-------------
--------<[[[X
-------->]]]X
-------------
-------------
-------<[[[[X
------->]]]]X
------------X
------------X
------------X
------------X
------------X
------------X
------------X
-----------EX
------------X
-----------EX
-----------EX
------------X
------------X
------------X
-----------EX
------------X
------------X
------------X
------------X
------------X
------------X
------------X
------------X
-----------EX
------------X
------------X
------------X
-----------XX
----------XXX
---------XXXX
--------XXXXX
-------XXXXXX
------XXXXXXX
------------X
------------X
-------o----X
-------o----X
------------X
------------X
------------X
------------X
------------X
-------------
-------o-----
-------------
------------X
------------X
-------------
-------o-----
-------------
------------X
------------X
------------X
------------X
------------X
----------XXX
------------X
------------X
------------X
----------XXX
------------X
------------X
------------X
------------X
------------X
------------X
-------------
-------------
-------o-----
-------o-----
-------------
------------X
-------------
-------o-----
-------o-----
-------------
------------X
------------X
------------X
------------X
------------X
------------X
------------X
-----------EX
------------X
------------X
------------X
------------X
------------X
------------X
-----------EX
-----------EX
------------X
-----------EX
------------X
------------X
---------<[[X
--------->]]X
------------X
------------X
------------X
------------X
------------X
------------X
------------X
------------X
------------X
----------<[X
---------->]X
------------X
------------X
-------------
----------XXX
-------------
--------XXXXX
-------------
------XXXXXXX
-------------
----XXXXXXXXX
----XXXXXXXXX
------------X
------------X
------------X
------------X
------------X
------------X
------------X
------------X
