------------X
------------X
------------X
------------X
------------X
------------X
------------X
------------X
------------X
------------X
------------X
------------X
------------X
------------X
------------X
--------?---X
------------X
------------X
------------X
--------S---X
--------Q--EX
----?---S---X
--------?---X
--------S---X
------------X
------------X
------------X
----------<[X
---------->]X
------------X
------------X
------------X
------------X
------------X
------------X
------------X
------------X
---------<[[X
--------->]]X
-----------EX
------------X
------------X
------------X
------------X
------------X
--------<[[[X
-------->]]]X
------------X
------------X
------------X
------------X
------------X
-----------EX
-----------EX
------------X
------------X
--------<[[[X
-------->]]]X
------------X
------------X
------------X
------------X
------------X
-------P----X
------------X
------------X
------------X
------------X
-------------
-------------
------------X
------------X
------------X
------------X
------------X
------------X
--------S---X
--------Q---X
-----E--S---X
----S-------X
---ES-------X
----S-------X
----S-------X
----S-------X
----S-------X
----S--------
----S--------
-------------
------------X
------------X
----S-------X
----S-------X
----S-------X
----?---S---X
-----------EX
-----------EX
------------X
------------X
------------X
--------S---X
--------P---X
------------X
------------X
------------X
------------X
--------?--EX
------------X
------------X
----Q---?---X
------------X
------------X
--------?---X
------------X
------------X
------------X
------------X
------------X
--------S---X
------------X
------------X
----S-------X
----S-------X
----S------EX
------------X
-----------EX
------------X
-----------EX
----S------EX
----?---S---X
----?---S---X
----S-------X
------------X
------------X
-----------XX
----------XXX
---------XXXX
--------XXXXX
------------X
------------X
--------XXXXX
---------XXXX
----------XXX
-----------XX
------------X
------------X
------------X
------------X
-----------XX
----------XXX
---------XXXX
--------XXXXX
--------XXXXX
-------------
-------------
--------XXXXX
---------XXXX
----------XXX
-----------XX
------------X
------------X
------------X
------------X
----------<[X
---------->]X
------------X
------------X
------------X
--------S---X
--------S---X
--------?---X
--------S---X
------------X
-----------EX
------------X
-----------EX
------------X
------------X
------------X
----------<[X
---------->]X
-----------XX
----------XXX
---------XXXX
--------XXXXX
-------XXXXXX
------XXXXXXX
-----XXXXXXXX
----XXXXXXXXX
----XXXXXXXXX
------------X
------------X
------------X
------------X
------------X
------------X
------------X
------------X
