------------X
------------X
------------X
------------X
------------X
------------X
------------X
------------X
------------X
------------X
------------X
------------X
------------X
------------X
---------<[[X
--------->]]X
------------X
------------X
----?---Q---X
------------X
------------X
------------X
------------X
------------X
------------X
-------------
-------------
------------X
------------X
------------X
------------X
------------X
------------X
------------X
--------o---X
-------o----X
-------o----X
--------o---X
------------X
------------X
------------X
------------X
------------X
------------X
------------X
------------X
------------X
------------X
------------X
------------X
------------X
------------X
------------X
------------X
------------X
------------X
------------X
----?---?---X
------------X
----?---?---X
------------X
------------X
------------X
------------X
------------X
------------X
------------X
------------X
------------X
------------X
------------X
-------------
-------------
-------------
-------------
------------X
------------X
------------X
------------X
------------X
------------X
------------X
------------X
--------?---X
--------?---X
----P---?---X
--------?---X
------------X
------------X
------------X
------------X
------------X
------------X
------------X
------------X
------------X
---------XXXX
------------X
-----o------X
-----o------X
-----o------X
-----o------X
------------X
------------X
------------X
------------X
------------X
------------X
------------X
--------<[[[X
-------->]]]X
------------X
-----o------X
-----o------X
-----o------X
-----o------X
------------X
------------X
------------X
------------X
------------X
------------X
------------X
------------X
------------X
--------<[-[X
-------->]-]X
------------X
-----o------X
-----o------X
-----o------X
-----o------X
------------X
------------X
------------X
------------X
------------X
------------X
------------X
--------?---X
--------?---X
----?---Q---X
----?---S----
----?---S----
----?---?---X
--------?---X
--------?---X
------------X
------------X
------------X
------------X
------------X
------------X
------------X
------------X
------------X
----------<[X
---------->]X
------------X
------------X
------------X
------------X
------------X
------------X
------------X
------------X
------------X
-------------
-------------
-------------
------------X
------------X
------------X
-------------
-------------
------------X
------------X
------------X
------------X
------------X
------------X
------------X
---------XXXX
-------------
-------------
------------X
------------X
------------X
------------X
------------X
------------X
------------X
------------X
------------X
------------X
------------X
------------X
------------X
------------X
------------X
------------X
-----------XX
----------XXX
---------XXXX
--------XXXXX
-------XXXXXX
------XXXXXXX
-----XXXXXXXX
----XXXXXXXXX
----XXXXXXXXX
------------X
------------X
------------X
--------X---X
------------X
------------X
------------X
------------X
