------------X
------------X
-------------
------------X
-----------EX
------------X
------------X
------------X
------------X
------------X
------------X
------------X
------------X
------------X
------------X
-------------
-------------
------------X
------------X
------------X
--------X----
--------X----
--------X----
------------X
------------X
------------X
-------------
----=--------
----=--------
-------------
--------X----
--------X----
--------X----
--------X----
-------------
-------------
------------X
------------X
-----------EX
-------------
-------------
-------------
------------X
------------X
------------X
------=------
------=------
------=---E--
------=---X--
------=---X--
------=---X--
-----==---X--
-----==------
--E--==------
E-?--==------
-----==------
-----==------
-----==------
-----==------
-----==------
-----==------
-----==------
-----==------
-----==------
-----==-X----
-----==-X----
-----==-X----
-----==-X----
-----==-X----
-----==------
----===------
----===------
----===------
----===------
----===-=----
----===-=----
----===-=----
----===-=----
----===-=----
----===-=----
-----==-=----
-----==-=----
-----==-=----
-----==-=----
-EX--=E-=X---
-EX--==-=X---
--X-E==-EX---
-----==-=X---
-----==-=X---
-----==X=----
-----==X=----
-----==X=----
-----==-=---X
-----==-=---X
-----==-=---X
-----==-=----
-----==-=---X
-----==-=---X
-----==-=---X
-----==-=---X
-----==-=----
-----==-=----
-----==-=---X
-----==-=---X
-----==-=---X
-----==-=----
-----==-X----
-----==-X----
-----==-X----
-----==-X----
-----==-X----
-----==-=----
-----==-=---X
-----==-=---X
-----==-=---X
-----==-=---X
-----==-=--EX
-----==-=----
-----==-=----
-----==-=----
-----==-=----
-----==-=----
-----==-=---X
-----==-=---X
-----==-=---X
-----==-=----
-----==-=----
-----==-=----
-----==-=----
-----==-=----
-----==------
----X==-----X
----X==-----X
----X==----EX
-----==-X---X
-----==-X----
-----==-X----
-----==-X----
-----==------
-----==------
-----==------
-----==------
-----==------
-----==------
-----==------
-----==------
------=------
------=------
------==-----
------==-----
------=------
------=------
------=------
------=------
-------------
----X--------
----X--------
----X--------
-------------
------------X
------------X
------------X
------------X
------------X
------------X
------------X
EE----------X
-----------EX
------------X
------------X
-----E------X
--E---------X
------------X
------------X
------------X
------------X
------------X
--------E---X
