------------X
------------X
------------X
------------X
------------X
------------X
------------X
------------X
------------X
------------X
------------X
------------X
------------X
------------X
------------X
------------X
--------E---X
------------X
------------X
------------X
----P-------X
----S-------X
----S-------X
------------X
------------X
------------X
------------X
------------X
------------X
------------X
------------X
----------E-X
--------?---X
--------?---X
--------?---X
--------?---X
------------X
------------X
------------X
------------X
------------X
------------X
------------X
------------X
---------E--X
------------X
------------X
------------X
------------X
------------X
------------X
------------X
------------X
------------X
------------X
--------S---X
--------S---X
--------X---X
--------X---X
--------S---X
------------X
------------X
------------X
------------X
------------X
------------X
-------------
-------------
------------X
------------X
------------X
------------X
------------X
------------X
------------X
----S---S---X
----S---S---X
----S---S---X
----S---S---X
----S---S---X
----S---S---X
----S---S---X
------------X
------------X
------------X
------------X
----P-------X
------------X
------------X
------------X
------------X
------------X
------------X
------------X
------------X
------------X
------------X
------------X
------------X
------------X
------------X
------------X
------------X
------------X
-----------EX
------------X
------------X
------------X
------------X
------------X
------------X
------------X
------------X
------------X
------------X
------------X
------------X
------------X
------------X
------------X
------------X
------------X
------------X
------------X
------------X
------------X
------------X
----S---S---X
----S---S---X
----S---S---X
----S---S---X
----S---S---X
------------X
------------X
---------XXXX
------------X
------------X
------------X
------------X
------------X
------------X
------------X
-------S----X
-------S----X
-P----------X
-------------
-----S-----XX
-----S----XXX
---------XXXX
--------XXXXX
-------XXXXXX
------XXXXXXX
------------X
------------X
------------X
-----------XX
----------XXX
---------XXXX
--------XXXXX
-------XXXXXX
------XXXXXXX
-----XXXXXXXX
----XXXXXXXXX
----XXXXXXXXX
------------X
------------X
------------X
------------X
------------X
------------X
------------X
------------X
-----------XX
------------X
------------X
------------X
------------X
------------X
------------X
------------X
