------------X
------------X
------------X
------------X
------------X
------------X
------------X
------------X
------------X
--------?---X
------------X
------------X
-------?----X
------------X
------------X
-------?----X
------------X
------------X
------------X
--------S---X
--------S---X
--------S---X
------------X
------------X
------------X
------------X
------------X
------------X
------------X
----------EEX
------------X
------------X
------------X
------------X
------------X
------------X
------------X
------------X
-------------
-------------
-------------
------------X
------------X
----------EEX
------------X
----------EEX
----------EEX
------------X
------------X
------------X
------------X
------------X
------------X
------------X
--------S---X
------------X
------------X
------------X
------------X
------------X
------------X
------------X
------------X
------------X
------------X
------------X
-----------XX
----------XXX
---------XXXX
--------XXXXX
-------------
-------------
-------------
-------------
-------E-----
---EP--E-----
-------------
-------E-----
--------XXXXX
-------------
-------------
--------XXXXX
----------XXX
----P-------X
----S-------X
----S-------X
----------EEX
----------EEX
------------X
------------X
------------X
------------X
------------X
------------X
------------X
------------X
------------X
------------X
------------X
------------X
------------X
------------X
------------X
------------X
----S---S---X
----S---S---X
----?---S---X
----S---S---X
----S---S---X
----S---S---X
----?---S---X
----S---S---X
----S---S---X
----S---S---X
--------S---X
------------X
------------X
------------X
------------X
------------X
------------X
-------------
----S--S-----
----S--S-----
----X--S-----
------------X
------------X
------------X
------------X
-----------XX
--------E-XXX
-------E-XXXX
--------XXXXX
-------XXXXXX
------XXXXXXX
-------------
-------------
------------X
------------X
------------X
------------X
------------X
------------X
----S---S---X
----?---?---X
----S---S---X
------------X
----------EEX
----S---S--EX
----?---?---X
----S---S--EX
------------X
------------X
------------X
------------X
------------X
------------X
------------X
------------X
--------S---X
--------X---X
--------S---X
--------S---X
--------S---X
------------X
------------X
------------X
---------XXXX
------XXXXXXX
------------X
-------------
-------------
-------------
------------X
------------X
------------X
-----------XX
----------XXX
---------XXXX
--------XXXXX
-------XXXXXX
------XXXXXXX
-----XXXXXXXX
----XXXXXXXXX
----XXXXXXXXX
------------X
------------X
------------X
------------X
------------X
------------X
------------X
------------X
-E---------XX
------------X
------------X
------------X
------------X
------------X
------------X
------------X
